1111111111111111111111111111111111
1E0000000000000C00000CX000000000E1
1010010100100000101001000000010111
1010010010101010001001000000010101
100000000CX0C0000000000000000000C1
1P0000000C00C0000X00000000000000C1
100000000C00C0000000000000000000C1
100000000C00C0000X0000000X00000001
100000000C00C000000001000X000000C1
100000000C00C000000000X00000000C11
100000000C00C00XXX0000000000X000C1
1111111111111111111111111111111111