1111111111111111111
11P000000C000000111
1000C0000C00C000001
100000000C0000X0111
1000C00X0C00C000001
10000C000C00C00X001
100000000C00C000001
100000000C00C00E001
1111111111111111111
