1111111111111111
1111111100111111
11X1111100000001
111111P111000001
111111C000000001
111E000000001111
1111111111111111
