1111111111111111111
111X11100000X00CC11
100000000000000CXC1
100X000000X00C00001
11E1111000C00000111
11E0000C0P000000E11
1111111111111111111